Rechnung=фактура
Odd Page Header – Section 1 –=Заглавие на нечетна страница – секция 1
Bezahlt=Платено
Zahlungsreferenznummer=Плащане №
Verkauft von=Продадено от
USt-IDNr.=ДДС №
Rechnungsdatum / Lieferdatum=Дата на фактура / Дата на доставка
Rechnungsdatum=Дата на фактура
Lieferdatum=Дата на доставка
Rechnungsnummer=Фактура №
Zahlbetrag=Сума за плащане
Geschäftsadresse=Бизнес адрес
Lieferadresse=Адрес за доставка
Um unseren Kundenservice zu kontaktieren, besuche=За да се свържете с нашия клиентски сервиз, посетете
Versendungsland=Страна на изпращане
Seite=Страница
von=от
USt.%=ДДС %
Zwischensumme=Меж. сума
ohne USt.=без ДДС
USt. Gesamt=Общо ДДС
Gesamtpreis=Обща цена
Rechnungsdetails=Детайли на фактурата
Bestelldatum=Дата на поръчка
Bestellnummer=Поръчка №
Auftraggeber=Възложител
Beschreibung=Описание
Menge=Кол.
Stückpreis=Ед. цена
inkl. USt.=вкл. ДДС
Versandkosten=Разходи за доставка
Aktionsrabatt=Промоционална отстъпка
Steuerfrei=Освободено от данък
Innergemeinschaftliche Lieferung=Вътреобщностна доставка
Innergemeinschaftliche=Вътреобщностна
Lieferung=Доставка
Artikel=Артикул
Richtlinie=Директива
Steuerfreie innergemeinschaftliche Lieferung=Данъчно освободена вътреобщностна доставка
LU-BIO-04=LU-BIO-04
Amazon EU S.à r.l.=Amazon EU S.à r.l.
Sitz der Gesellschaft=Седалище на дружеството
eingetragen im Luxemburgischen Handelsregister unter=Регистрирано в Люксембургския търговски регистър под
Stammkapital=Основен капитал
Niederlassung Deutschland=Филиал в Германия
Sitz der Zweigniederlassung=Седалище на клона
eingetragen im Handelsregister des Amtsgerichts=Регистрирано в търговския регистър на окръжния съд
USt-ID=ДДС №
ist bei der Stiftung ear für Elektro- und Elektronikgeräte registriert=е регистрирано във фондация EAR за електрически и електронни уреди
WEEE-Reg.-Nr.=WEEE рег. номер
Deutschland=Германия
EUR=EUR
VAT=ДДС
TCI LTD=ТИ СИ АЙ ЕООД
4 BULGARIA BLVD.=бул. България №4
4000, 4 Bulgaria blvd.=4000,бул.България №4
PLOVDIV, BULGARIA, 4000=Пловдив, България, 4000
Aleksandar Kalinov=Александър Калинов
blvd. Cherni Vrah 81, fl. 4, apt. 13=бул.Черни Връх №81,ет.4.ап.13
Sofia, Sofia, 1407=София,София,1407
Bestellinformationen=Информация за поръчката
Januar=януари
Februar=февруари
März=март
April=април
Mai=май
Jun=юни
Juli=юли
August=август
September=септември
Oktober=октомври
November=ноември
Dezember=декември
USt.=ДДС
Invoice=Фактура
Abweichende Lieferanschrift:=Алтернативен адрес за доставка:
blvd. Cherni Vrah 81=бул.Черни Връх №81
fl. 4, apt. 13=ет.4 ап.13
1407 Sofia=1407 София
Sofia=София
Bulgaria=България
Pagato=Платено
Numero di riferimento del pagamento=Плащане №
Venduto da=Продадено от
P. IVA=ДДС:
Data di fatturazione / Data di consegna=Дата на фактуриране / Дата на доставка
Numero fattura=Номер на фактура
Per domande relative al tuo ordine, ti preghiamo di visitare il sito www.amazon.it/contact-us=За въпроси относно вашата поръчка, моля, посетете www.amazon.it/contact-us
Indirizzo sede legale=Бизнес адрес
Indirizzo di spedizione=Адрес за доставка
Informazioni sull'ordine=Информация за поръчката
Data ordine=Дата на поръчката
Contratto=Договор
Ordinato da=Подредено от
Dettagli fattura=Данни за фактурата
Descrizione=Описание
Quant.=Кол.
P. Unitario=Ед.цена
IVA esclusa=без ДДС
IVA=ДДС
IVA inclusa=с ДДС
Prezzo Totale=Меж.сума
Costi di spedizione=Разходи за доставка
Promozion=Промоции
Totale fattura=Тотал
Subtotale IVA=Меж.сума с ДДС
Totale=Тотал
(1) Cessione Intracomunitaria di beni esenti - Articolo 138 Direttiva 2006/112/EC=(1) Вътреобщностна доставка на освободени стоки - член 138 от Директива 2006/112/ЕО
Beni spediti da=Стоки, изпратени от
Francia=Франция
Pagina=Стр.
di=от
Totale da pagare=Общо за плащане